アイジヨウ → ジヨウアイ
アクシユウ → シユウアク
アツジヨウ → ジヨウアツ
アンフイニ → ニンフイア
イエヤシキ → エイシヤキ
イキリヨウ → リヨウイキ
イツキヨウ → キヨウツイ
イツシユウ → シユウイツ
イヤクキン → キヤクイン
インシヨウ → シヨウイン
インシヨク → シヨクイン
インターン → ターンイン
インリヨウ → リヨウイン
インリヨク → リヨクイン
ウンキヨウ → キヨウウン
ウンテンシ → シウンテン
エンシユウ → シユウエン
エンシヨウ → シヨウエン
エンチユウ → ユウエンチ
エンチヨウ → ヨウチエン
エンビカン → カエンビン
オウシヨウ → シヨウオウ
オウジヨウ → ジヨウオウ
オウリヨク → リヨクオウ
オフライン → ラインオフ
オンジヨウ → ジヨウオン
カーレース → レースカー
カイキヨウ → キヨウカイ
カイギヨウ → ギヨウカイ
カイシヨウ → シヨウカイ
カイジヨウ → ジヨウカイ
カイセンシ → シセイカン
カイセンシ → シンセカイ
カイチヨウ → チヨウカイ
カイリヨウ → リヨウカイ
カクシユウ → シユウカク
カクチヨウ → チヨウカク
カツキヨウ → キヨウカツ
カツシヨク → シヨツカク
カツセイカ → セツカイカ
カライバリ → カリバライ
カンキコウ → キカンコウ
カンキセン → キンセンカ
カンキヨウ → キヨウカン
カンシユウ → シユウカン
カンシヨウ → シヨウカン
カンジヨウ → ジヨウカン
カンチヨウ → チヨウカン
カンテイシ → テイカンシ
ガイシヨウ → シヨウガイ
ガイシヨク → シヨクガイ
ガクシユウ → シユウガク
ガツシヨウ → シヨウガツ
ガランダー → ガンダーラ
ガンジヨウ → ジヨウガン
キシンゴウ → シンゴウキ
キシンシヤ → シヤシンキ
キシンシヤ → シンヤシキ
キツシヨウ → キヨウシツ
キユウコウ → コウキユウ
キユウサイ → サイユウキ
キユウシヨ → キヨシユウ
キユウシヨ → シヨキユウ
キユウシン → シユウキン
キユウシン → シンキユウ
キユウジヨ → キヨウジユ
キユウジヨ → キヨジユウ
キユウスイ → スイキユウ
キヨウコウ → コウキヨウ
キヨウコツ → コツキヨウ
キヨウジユ → キヨジユウ
キヨウジン → ジヨウキン
キヨウセン → センヨウキ
キヨウゾウ → ゾウキヨウ
キヨウダイ → ダイキヨウ
キヨウテイ → テイキヨウ
キヨウトウ → トウキヨウ
キヨウハン → ハンキヨウ
キヨウユウ → ヨウキユウ
キヨウレツ → レツキヨウ
キヨクセン → センキヨク
キヨクトウ → トウキヨク
キヨシユウ → シヨキユウ
キンシコウ → コウキシン
キンシヨウ → シヨウキン
キンシヨウ → シンキヨウ
キンチヤク → チンキヤク
キンリヨウ → リヨウキン
ギンシヨウ → シンギヨウ
クヤクシヨ → ヤクシヨク
クラツスス → スラツクス
ケイシヨウ → ケイヨウシ
ケイシヨウ → シヨウケイ
ケイチヨウ → チヨウケイ
ケイヨウシ → シヨウケイ
ケツシユウ → シユウケツ
ケツジヨウ → ツケジヨウ
ケンシヨウ → シヨウケン
ケンジヨウ → ジヨウケン
ケンタイキ → タイキケン
ケンタンカ → タンケンカ
ケンチヨウ → チヨウケン
ゲンシユツ → シユツゲン
ゲンシヨウ → シヨウゲン
ゲンチユウ → チユウゲン
コウエンジ → コウジエン
コウシヨウ → シヨウコウ
コウジヨウ → ジヨウコウ
コウリユウ → リユウコウ
コウリヨク → リヨウコク
コツヒシツ → ヒシツコツ
コリシヨウ → シヨウコリ
コンシヤス → シンコヤス
コンジヨウ → ジヨウコン
サイシヨウ → シヨウサイ
サイジヨウ → ジヨウサイ
サイリヨウ → リヨウサイ
サクシユウ → シユウサク
サクシヨン → シヨクサン
サンシヨウ → シヨウサン
ザイジユウ → ジユウザイ
ザイジヨウ → ジヨウザイ
シカイシヤ → シシヤカイ
シキジヨウ → シヨウジキ
シキジヨウ → ジヨウシキ
シセイカン → シンセカイ
シツシヨウ → シヨウシツ
シツリヨウ → シヨウリツ
シヤシヨウ → シヨウシヤ
シヤシンキ → シンヤシキ
シヤチユウ → チユウシヤ
シユウキン → シンキユウ
シユウコツ → シユツコウ
シユウシン → シンシユウ
シユウジン → シンジユウ
シユウジン → ジユウシン
シユウダン → ダンシユウ
シユウニン → ニユウシン
シユウネン → ネンシユウ
シユウバン → バンシユウ
シユウフク → フクシユウ
シユウヘン → ヘンシユウ
シユウヨウ → ユウシヨウ
シユウレン → レンシユウ
シユクジヨ → シヨクジユ
シユクセイ → セイシユク
シユチヨウ → シヨチユウ
シユリヨウ → リヨウシユ
シヨウキン → シンキヨウ
シヨウシン → シンシヨウ
シヨウジキ → ジヨウシキ
シヨウジン → シンジヨウ
シヨウジン → ジヨウシン
シヨウセイ → セイシヨウ
シヨウセン → センシヨウ
シヨウソウ → ソウシヨウ
シヨウソク → ソウシヨク
シヨウゾク → ゾウシヨク
シヨウタイ → タイシヨウ
シヨウテイ → テイシヨウ
シヨウトウ → トウシヨウ
シヨウドウ → ドウシヨウ
シヨウドク → シヨクドウ
シヨウドク → ドウシヨク
シヨウドク → ドクシヨウ
シヨウニン → シンニヨウ
シヨウニン → ニンシヨウ
シヨウネン → ネンシヨウ
シヨウノウ → ノウシヨウ
シヨウハイ → ハイシヨウ
シヨウバイ → バイシヨウ
シヨウブン → ブンシヨウ
シヨウホウ → ホウシヨウ
シヨウボウ → ボウシヨウ
シヨウメイ → メイシヨウ
シヨウレイ → レイシヨウ
シヨウロン → ロンシヨウ
シヨクドウ → ドウシヨク
シヨクドウ → ドクシヨウ
シヨクブツ → ブツシヨク
シヨクヨウ → ヨウシヨク
シヨクリン → シンリヨク
シンジユウ → ジユウシン
シンジヨウ → ジヨウシン
シンチユウ → チユウシン
シンチヨウ → チヨウシン
シンチヨク → チヨクシン
シンニヨウ → ニンシヨウ
ジツシヨウ → ジヨウシツ
ジユウシヨ → ジユシヨウ
ジユウシヨ → ジヨウシユ
ジユウタイ → タイジユウ
ジユウタン → タンジユウ
ジユウトウ → ユウトウジ
ジユウヨウ → ユウジヨウ
ジユカイン → ジユンカイ
ジユシヨウ → ジヨウシユ
ジユンウチ → ジンチユウ
ジユンスイ → スイジユン
ジヨウスイ → スイジヨウ
ジヨウスウ → スウジヨウ
ジヨウセイ → セイジヨウ
ジヨウセツ → セツジヨウ
ジヨウセン → センジヨウ
ジヨウゼツ → ゼツジヨウ
ジヨウソウ → ソウジヨウ
ジヨウゾウ → ゾウジヨウ
ジヨウタイ → タイジヨウ
ジヨウタン → タンジヨウ
ジヨウダン → ダンジヨウ
ジヨウチヨ → チヨウジヨ
ジヨウドウ → ドウジヨウ
ジヨウニン → ニンジヨウ
ジヨウネツ → ネツジヨウ
ジヨウノウ → ノウジヨウ
ジヨウハツ → ハツジヨウ
ジヨウバン → バンジヨウ
ジヨウブツ → ブツジヨウ
ジヨウブン → ブンジヨウ
ジヨウボウ → ボウジヨウ
ジヨウマン → マンジヨウ
ジヨウモウ → モウジヨウ
ジヨウヨウ → ヨウジヨウ
ジヨウリク → リクジヨウ
ジヨウレイ → レイジヨウ
ジヨウレツ → レツジヨウ
ジヨウロウ → ロウジヨウ
スイチユウ → チユウスイ
セイチヨウ → チヨウセイ
セイリユウ → リユウセイ
センチユウ → チユウセン
ソウチヨウ → チヨウソウ
ソウヒヨウ → ヒヨウソウ
ソウリヨウ → リヨウソウ
タウスケツ → タスウケツ
タトウキン → タンキトウ
ダイヒヨウ → ヒヨウダイ
チシリヨウ → チヨウリシ
チツピング → ピツチング
チユウテン → テンチユウ
チユウデン → デンチユウ
チユウドウ → ドウチユウ
チヨウエキ → ヨウエキチ
チヨウコツ → チヨツコウ
チヨウジン → チンジヨウ
チヨウチン → チンチヨウ
チヨウナン → ナンチヨウ
テイシユツ → テイツシユ
ドウシヨク → ドクシヨウ
バージヨン → バンジヨー
ヒツマブシ → ヒマツブシ
ビールビン → ビンビール
ブロスター → ロブスター
マンスリー → リースマン
モノワライ → ワライモノ
リツリヨウ → リヨウリツ
リヨウジン → リンジヨウ
ロウシヨク → ロクシヨウ