アツプセツト → セツトアツプ
ウスコウバイ → コウバイスウ
ウツラウツラ → ツツウラウラ
エイワジテン → ワエイジテン
カレーライス → ライスカレー
カロトウセン → トウセンカロ
キユウシユウ → シユウキユウ
キユウシヨク → キヨウシユク
キユウシヨク → シユウキヨク
キユウジヨウ → ジヨウキユウ
キユウリヨウ → キヨウリユウ
キヨウシユウ → シユウキヨウ
キヨウシユク → シユウキヨク
キヨウシヨク → キヨクシヨウ
キンシチヨウ → チヨウシンキ
ギユウニユウ → ニユウギユウ
ギヨクシヨウ → シヨクギヨウ
グラスワイン → ワイングラス
ケイシチヨウ → ケイシヨウチ
シートバツク → バツクシート
シエルボデイ → ボデイシエル
シツモンバコ → シンモツバコ
シヤクジヨウ → ジヤクシヨウ
シユウシヨク → シユクシヨウ
シユウチヨウ → シヨウチユウ
シユウチヨウ → チユウシヨウ
シユウチヨウ → チヨウシユウ
シユウリヨウ → リヨウシユウ
シヨウシヨク → シヨクシヨウ
シヨウジヨウ → ジヨウシヨウ
シヨウチユウ → チユウシヨウ
シヨウチユウ → チヨウシユウ
シヨウチヨウ → チヨウシヨウ
シヨウリヤク → リヤクシヨウ
ジユウシヨウ → ジヨウシユウ
ステイホーム → ホームステイ
ソウカンタン → ソウタンカン
チユウシヨウ → チヨウシユウ
テモチブサタ → テモチブタサ
ハンドバツク → バツクハンド
フイクシヨン → フクインシヨ