アキユームレータ → アキユムレーター
アフイルテンソウ → フアイルテンソウ
アフカリグンダン → アフリカグンダン
アリユウサンエン → リユウサンアエン
アレンジフラワー → フラワーアレンジ
アンコウテンノウ → コウアンテンノウ
アンゴウツウシン → ツウシンアンゴウ
アンテイカブヌシ → カブヌシテイアン
イアクジヨウソウ → イアクソウジヨウ
イインカイソシキ → ソシキイインカイ
イキヨクドウコウ → ドウコウイキヨク
イジヨウカンカク → カンカクイジヨウ
イジヨウセイカク → セイカクイジヨウ
イジヨウセツキン → イツセンジヨウキ
イチロクギンコウ → ロクイチギンコウ
イツシイツチヨウ → イツチヨウイツシ
イツシツイツトク → イツトクイツシツ
イツテキケンコン → ケンコンイツテキ
イツパンシヤカイ → シヤカイイツパン
イツポウコウツウ → イツポウツウコウ
イトーヨーカドウ → イトウヨーカドー
ウイルスカンエン → カンエンウイルス
ウオーターバツク → バツクウオーター
ウチユウクウコウ → コウクウウチユウ
ウラガキジヨウト → ジヨウトウラガキ
ウランノウシユク → ノウシユクウラン
ウリヨウキヨウド → キヨウドウリヨウ
ウンエイドリヨク → エイヨウドリンク
ウンサンムシヨウ → ウンシヨウムサン
エイガゲイジユツ → ゲイジユツエイガ
エイガゲキジヨウ → ゲキジヨウエイガ
エイギヨウキヨカ → キヨカエイギヨウ
エイギヨウジカン → ジカンエイギヨウ
エイセイツウシン → ツウシンエイセイ
エイセイホウソウ → ホウソウエイセイ
エイユウジヨジシ → ジシユジヨウエイ
エイヨウセイブン → セイブンエイヨウ
エスエフエツクス → エフエスエツクス
エツクスエムエス → エムエスエツクス
エヌテイーテイー → テイーエヌテイー
エネルギーシゲン → ゲンシエネルギー
エンケイカイヨウ → ケイカンエイヨウ
エンダカドルヤス → エンヤスドルダカ
エンチユウジヨウ → ジヨウエンチユウ
エンボウシンリヨ → シンボウエンリヨ
エンボウシンリヨ → シンリヨエンボウ
エンメイソクサイ → ソクサイエンメイ
エンヨウコウカイ → カイヨウコウエン
オウリヨクシヨク → リヨクオウシヨク
オンセイゴウセイ → ゴウセイオンセイ
オンセイタジユウ → タジユウオンセイ
オンセンリヨコウ → コリヨウオンセン
カイガイコウケン → ガイコウカンケイ
カイガイタイケン → タイガイカンケイ
カイキゲンシヨウ → ゲンシキヨウカイ
カイキシヨウセツ → セイカツヨウシキ
カイキユウシヨウ → シユウキヨウカイ
カイケイケツサン → ケイサツカンケイ
カイシヤカツドウ → シヤカイカツドウ
カイシヤカンケイ → シヤカイカンケイ
カイシヤコウセイ → コウセイカイシヤ
カイシヤセイカツ → シヤカイセイカツ
カイシヤニンゲン → ニンゲンシヤカイ
カイシユウギヨウ → ギヨウシユウカイ
カイジヨケイヤク → ケイヤクカイジヨ
カイセンセイギヨ → カンセイセイギヨ
カイソウシヤカイ → シヤカイカイソウ
カイチヨウシヨク → シヨウカイチヨク
カイチヨウシヨク → チヨウシヨクカイ
カイテンホウコウ → コウホウカイテン
カイハツギジユツ → ギジユツカイハツ
カイハツジギヨウ → ジギヨウカイハツ
カイヨウキシヨウ → シヨウカイキヨウ
カイリヨウコウジ → リヨウカイジコウ
カイリヨクシヨク → リヨクカイシヨク
カカクキヨウソウ → キヨウソウカカク
カガクコウギヨウ → コウギヨウカガク
カガクコウシヨウ → シヨウガクコウカ
カガクリヨウイキ → キヨウイクガカリ
カキユウカイソウ → カソウカイキユウ
カキヨウウンドウ → キヨウカウンドウ
カクチヨウキノウ → キノウカクチヨウ
カクリヨウキユウ → キユウカクリヨウ
カコウゲンリヨウ → ゲンリヨウコウカ
カコウシヨクヒン → シヨクヒンカコウ
カジヨウセイサン → セイサンカジヨウ
カツキンセイレイ → セイレイカツキン
カツマクカンセツ → カンセツカツマク
カテイキヨウイク → キヨウイクカテイ
カナヤマオンセン → ナカヤマオンセン
カナヤマオンセン → ヤマナカオンセン
カナワリオンセン → ナリカワオンセン
カブキワカシユウ → ワカシユウカブキ
カヘイシヨウヒン → シヨウヒンカヘイ
カヘイリユウツウ → リユウツウカヘイ
カマサキオンセン → サカマキオンセン
カミスワオンセン → スミカワオンセン
カミノユオンセン → ユノカミオンセン
カリヨクセイアツ → セイアツカリヨク
カロリーシヨウヒ → シヨウヒカロリー
カワイダオンセン → カワダイオンセン
カンガルーネズミ → ネズミカンガルー
カンキユウチユウ → キユウカンチユウ
カンコツダツタイ → ダツタイカンコツ
カンジキヨウイク → キヨウイクカンジ
カンジヨウシユウ → シユウカンジヨウ
カンセイウンドウ → センカイウンドウ
カンセイシヤゲキ → シヤゲキカンセイ
カンセツキヨウサ → キヨウサカンセツ
カンセツコウヨウ → ヨウセツコウカン
カンセツサギヨウ → センギヨウサツカ
カンセンテツドウ → テツドウカンセン
カンソクキキユウ → キキユウカンソク
カンテイシヨブン → ブンシヨカンテイ
カンナイホウソウ → ナンカイホウソウ
カンリジヨウホウ → ジヨウホウカンリ
カンレイチシヨウ → シレイチヨウカン
カンワダイジテン → ダイカンワジテン
ガイコウモンダイ → コウガイモンダイ
ガイシヤハンバイ → ハンバイガイシヤ
ガクゲイジユツブ → ゲイジユツガクブ
ガクシユウキカン → シユウガクキカン
ガクシユウジカン → シユウガクジカン
ガクブキヨウイク → キヨウイクガクブ
キカイコウジヨウ → コウジヨウキカイ
キコウジユンノウ → キユウジンノコウ
キシヨウトクホウ → シホウトウキヨク
キツチンユニツト → ユニツトキツチン
キネンシユツパン → シユツパンキネン
キボウシヨクシユ → キボシユクシヨウ
キヤミソールブラ → ブラキヤミソール
キユウキコウテイ → キユウキテイコウ
キユウケイジカン → ケイキカンジユウ
キユウシヨウシヤ → キヨウシユウシヤ
キユウシヨウシヤ → シユウキヨウシヤ
キユウシヨウタイ → キユウタイシヨウ
キユウジユウシヨ → ジヨウキユウシユ
キユウセイチヨウ → チヨウセイキユウ
キユウセイリヨク → セイキユウリヨク
キユウチユウコウ → コウチユウキユウ
キヨウイクゲンバ → ゲンバキヨウイク
キヨウイクジヨウ → ヨウジキヨウイク
キヨウインシカク → シイクカンキヨウ
キヨウインシカク → シカンキヨウイク
キヨウシユウシヤ → シユウキヨウシヤ
キヨウシユウシヨ → シユウキヨウシヨ
キヨウシユウシヨ → シユウシヨキヨウ
キヨウシヨクシヤ → シヨウシヤキヨク
キヨウシヨクセイ → シヨウキヨクセイ
キヨウジヨウモチ → キヨウチヨウモジ
キヨウセイカンサ → キヨウセイサンカ
キヨウチヨウサク → チヨウキヨウサク
キヨウチヨウシン → キンチヨウシヨウ
キヨウチヨウシン → シヨウキンチヨウ
キヨウトダイカン → キヨトウカイダン
キヨウドウインシ → シドウキヨウイン
キヨウドウシヨク → シヨクドウキヨウ
キヨウハクジヨウ → ジハクキヨウヨウ
キヨウハシントウ → シントウキヨウハ
キヨウヤクジコウ → ジヨウコウキヤク
キヨウヤクジコウ → ジヨウヤクキコウ
キヨクシユウロク → シユウロクキヨク
キヨクチヨウシツ → チヨウシヨクツキ
キヨクヒツブブン → ブブンキヨクヒツ
キヨジユウチイキ → ジユウキヨチイキ
キヨセイガンボウ → センキヨボウガイ
キンセツセントウ → セツキンセントウ
キンチヨウシヨウ → シヨウキンチヨウ
キンムジカンガイ → ジカンガイキンム
キンムジヨウタイ → ムキンジヨウタイ
キンユウシジヨウ → シユウキヨウジン
キンユウシジヨウ → シンジユウキヨウ
キンユウシジヨウ → ジヨウキユウシン
ギジユツケイサン → ケイサンギジユツ
ギジユツセツケイ → セツケイギジユツ
ギヨウシヤシメイ → シメイギヨウシヤ
ギヨウセイコツカ → コツカギヨウセイ
ギヨウセイシヨク → シヨクギヨウセイ
ギヨウムテイケイ → テイケイギヨウム
ギヨウムレンラク → レンラクギヨウム
ギンコウトリヒキ → トリヒキギンコウ
ギンコウワリビキ → ワリビキギンコウ
クアレバラクアリ → ラクアレバクアリ
クウカンコウセイ → コウクウカンセイ
クシヨウネンブツ → シヨウネンブツク
クラフトペーパー → ペーパークラフト
クンシユセンセイ → センセイクンシユ
グラスフアイバー → フアイバーグラス
グンジカンキヨウ → グンジキヨウカン
ケイカクケイザイ → ケイザイケイカク
ケイカクセイサン → セイサンカクケイ
ケイカクセイサン → セイサンケイカク
ケイキジユンカン → ジユンカンキケイ
ケイサツシヨブン → ケイサツブンシヨ
ケイザイシヤカイ → シヤカイケイザイ
ケイザイセイカツ → セイカツケイザイ
ケイザイセンソウ → センソウケイザイ
ケイザイトウセイ → トウセイケイザイ
ケイザイブロツク → ブロツクケイザイ
ケイシユウサツカ → サイシユウケツカ
ケイシヨウリヤク → シヨウリヤクケイ
ケイジヨウミヤク → ジヨウミヤクケイ
ケイセイヲタテル → セイケイヲタテル
ケイトウモンダイ → トウケイモンダイ
ケイヤクシヤカイ → シヤカイケイヤク
ケツコンセイサク → ケンセツコクサイ
ケツシヨウコウシ → シコウケツシヨウ
ケツセイカンエン → セツカイケンエン
ケツセイシンダン → シンケイセツダン
ケツセイタイカイ → セイカツケイタイ
ケツセンタイカイ → セイカツタイケン
ケンチクヨウシキ → ヨウシキケンチク
ゲンシサンギヨウ → シゲンサンギヨウ
ゲンテイセキニン → セイテキニンゲン
ゲンバチユウケイ → チユウケイゲンバ
コウカイシジヨウ → シジヨウコウカイ
コウカイシリヨウ → シカイリヨウコウ
コウカンケイシキ → コウシキケンカイ
コウカンボウエキ → ボウエキカンコウ
コウクウダイタイ → ダイタイクウコウ
コウゲイビジユツ → ビジユツコウゲイ
コウゲキヘンタイ → ヘンタイコウゲキ
コウコウヤキユウ → ヤコウキユウコウ
コウコクセンデン → センデンコウコク
コウシユウキセイ → コウセイシユウキ
コウシヨウジユツ → シユツジヨウコウ
コウシヨツメイン → シヨウコインメツ
コウジハツチユウ → ハツチユウコウジ
コウジヨウチヨウ → コウジヨウヨウチ
コウジヨウヘイキ → ヘイキコウジヨウ
コウセイヨウケン → セイコウヨウケン
コウソクカイテン → コウソクテンカイ
コウタイセンシユ → センシユコウタイ
コウツウボウガイ → ツウコウボウガイ
コウテンシユウキ → シキユウコウテン
コウドウホウシン → シンドウホウコウ
コウニユウシキン → シンキコウニユウ
コウニンテンノウ → ニンコウテンノウ
コウブンブンセキ → ブンコウブンセキ
コウユウカンケイ → ユウコウカンケイ
コウリユウジヨウ → リユウジヨウコウ
コウリユウジンジ → ジンジコウリユウ
コウリヨウブソク → ブリヨクコウソウ
コウワカイジヨウ → ワカイジヨウコウ
コキヨリユウバン → リユウバンコキヨ
コクサイキギヨウ → コクサイキヨウギ
コクサイクウコウ → コクサイコウクウ
コクナイカンゼイ → ナイコクカンゼイ
コクナイユウビン → ナイコクユウビン
コクミンセイトウ → コクミントウセイ
コシノユオンセン → ユノコシオンセン
コヅツミユウビン → ユウビンコヅツミ
コンゴウカンセン → センカンコンゴウ
コンベヤーベルト → ベルトコンベヤー
ゴウホウライラク → ゴウホウラクライ
ゴウロクオンセン → ロクゴウオンセン
サイカイモクヨク → モクヨクサイカイ
サイサイネンネン → ネンネンサイサイ
サイシユウヨセン → シユウセイヨサン
サイジヨウリユウ → ジユウサイリヨウ
サイテンホウホウ → サンテイホウホウ
サイボウコウガク → ボウガイコウサク
サイボウコウガク → ボウサイコウガク
サギヨウキジユン → ジユンギヨウサキ
サクセンカンテイ → セイサクテンカン
サクテキレーダー → レーダーサクテキ
サケトバラノヒビ → バラトサケノヒビ
サンギヨウキバン → バンキンサギヨウ
ザイサンソウゾク → ソウゾクザイサン
シーデイシングル → シングルシーデイ
シイクカンキヨウ → シカンキヨウイク
シキユウケイカン → シユウケイキカン
シジヨウカイホウ → ジヨウホウシカイ
システムセイギヨ → セイギヨシステム
システムデイスク → デイスクシステム
システムフアイル → フアイルシステム
シチヨウカクシツ → チカクシヨウシツ
シヒヨウセイブツ → セイブツシヒヨウ
シホウカンチヨウ → シホウチヨウカン
シミユレーシヨン → シユミレーシヨン
シヤインミナライ → ミナライシヤイン
シヤカイタイセイ → シヤセイタイカイ
シヤカイホウガク → ホウシヤカイガク
シヤゲキデンタン → デンタンシヤゲキ
シヤゲキトウセイ → トウセイシヤゲキ
シヤゲキレーダー → レーダーシヤゲキ
シヤシンシリヨウ → シリヨウシヤシン
シヤシンデンソウ → デンソウシヤシン
シヤフトドライブ → ドライブシヤフト
シユウカヘイゲツ → シユウゲツヘイカ
シユウカヘイゲツ → ヘイゲツシユウカ
シユウカンシヨウ → シヨウカンシユウ
シユウカンシヨウ → シヨウシユウカン
シユウガクジドウ → ジドウガクシユウ
シユウキヨウカン → シユウヨウキカン
シユウキヨウシヨ → シユウシヨキヨウ
シユウキヨウシン → シンシユウキヨウ
シユウキヨウジン → シンジユウキヨウ
シユウキヨウジン → ジヨウキユウシン
シユウケイヒヨウ → ヒヨウシユウケイ
シユウケンリヨウ → シヨウリユウケン
シユウゲツヘイカ → ヘイゲツシユウカ
シユウサンリゴウ → リゴウシユウサン
シユウシヨクカイ → シユクシヨウカイ
シユウシヨクリツ → シユクシヨウリツ
シユウシンキンコ → シンコキンシユウ
シユウシンジカン → シユウジンカンシ
シユウセイリヨウ → シユウリヨウセイ
シユウセキジヨウ → ジユウシヨウセキ
シユウセキジヨウ → ジヨウセキシユウ
シユウヨウジンチ → チヨウシユウジン
シユウヨウジンチ → チヨウジユウシン
シユウリヨウシヨ → リヨウシユウシヨ
シユウリヨウシヨ → リヨウシユシヨウ
シユクジユウゴウ → ジユウシユクゴウ
シユクダイチヨウ → チユウシヨクダイ
シユシヨウジヨウ → シヨウジヨウシユ
シユツキンジカン → ジユンカンキシツ
シユツシンチホウ → チホウシユツシン
シユツジヨウケン → ジユンケツシヨウ
シユツニユウコク → ニユウシユツコク
シユツリシヨウジ → シリヨウジユツシ
シユリヨウジユウ → ジヨウリユウシユ
シユリヨウチヨウ → チヨウシユリヨウ
シユンセツポンプ → ポンプシユンセツ
シヨウイハンシヤ → シヨウシヤハンイ
シヨウカイチヨク → チヨウシヨクカイ
シヨウカンシユウ → シヨウシユウカン
シヨウカンチヨウ → シヨウチヨウカン
シヨウギヨウケン → シヨウケンギヨウ
シヨウギヨウコウ → シヨウコウギヨウ
シヨウコウジヨウ → シヨウジヨウコウ
シヨウジユンカン → ジユンカンシヨウ
シヨウジヨウシン → シヨウジンシヨウ
シヨウジヨウタイ → シヨウタイジヨウ
シヨウジヨウチヤ → チヨウジヨウシヤ
シヨウジヨウホウ → ジヨウホウシヨウ
シヨウソクギヨウ → シヨクギヨウソウ
シヨウタイキヤク → タイシヤクキヨウ
シヨウネンヒコウ → ヒコウシヨウネン
シヨウヒコウドウ → シヨウヒドウコウ
シヨウヒンミホン → ミホンシヨウヒン
シヨウモンジヨウ → モンジヨウシヨウ
シヨクヒンホゾン → ホゾンシヨクヒン
シヨクブツセンイ → センイシヨクブツ
シヨクブツセンイ → ブンセツイシヨク
シヨクモツセンイ → センイシヨクモツ
シヨクユウジヨウ → シヨクヨウジユウ
シヨクヨウジヨウ → ヨウシヨクジヨウ
シヨブントリケシ → トリケシシヨブン
シリヨウチヨウサ → チヨウサシリヨウ
シンケイマツタン → マツタンシンケイ
シンコクノウゼイ → ノウゼイシンコク
シンジユウキヨウ → ジヨウキユウシン
シンジヨテンユウ → シンユウテンジヨ
シンジヨテンユウ → テンユウシンジヨ
シンダイレツシヤ → レツシヤシンダイ
シンデイーローパ → シンデイローパー
シンドウハジユウ → ジユウドウシハン
シンボウエンリヨ → シンリヨエンボウ
シンユウテンジヨ → テンユウシンジヨ
シンリヨウナイカ → ナイカシンリヨウ
ジカンキユウデン → ジユウデンキカン
ジカンチヨウセイ → チジヨウカイセン
ジカンチヨウセイ → チジヨウカンセイ
ジコキユウシユウ → ジシユキユウコウ
ジセイジヨウタイ → ジヨウジセイタイ
ジツケンドウブツ → ドウブツジツケン
ジツシヨウリヨウ → ジヨウシヨウリツ
ジユウカンキヨウ → ユウキカンジヨウ
ジユウシヨウシヤ → ジヨウシユウシヤ
ジユウシヨウセキ → ジヨウセキシユウ
ジユウニシチヨウ → ジユウニチヨウシ
ジユウニメンタイ → ニジユウメンタイ
ジユウヨウシレイ → ジヨウレイシユウ
ジユウリヨウイキ → ジヨウリユウイキ
ジユカセキジヨウ → セキジヨウジユカ
ジヨウイセイセキ → セイセキジヨウイ
ジヨウカンチヨウ → ジヨウチヨウカン
ジヨウカンチヨウ → チヨウジヨウカン
ジヨウキユウセイ → セイキユウジヨウ
ジヨウコウキヤク → ジヨウヤクキコウ
ジヨウコウジカン → ジンコウカジヨウ
ジヨウセツキカン → セツキカンジヨウ
ジヨウチユウルイ → チヨウジユウルイ
ジヨウチヨウカン → チヨウジヨウカン
ジヨウチヨウセイ → ヨウジチヨウセイ
ジヨウホウソウサ → ソウサジヨウホウ
ジヨウホウリロン → ジヨウホウロンリ
ジヨウリクブタイ → リクジヨウブタイ
ジンインボシユウ → ボシユウジンイン
スクリユーボール → ボールスクリユー
スタジオロクオン → ロクオンスタジオ
セイカンツウシン → ツウシンカイセン
セイゲンネンレイ → ネンレイセイゲン
セイコウトウテイ → トウコウセイテイ
セイサンカクケイ → セイサンケイカク
セイシゲンリヨウ → セイリゲンシヨウ
セイシコウジヨウ → セイジシヨウコウ
セイシヨクリヨク → セイリヨクシヨク
セイシンイツトウ → セイシントウイツ
セイシンケイタイ → タイセイシンケイ
セイシンコウヨウ → センイコウシヨウ
セイジヨウサドウ → セイジヨウドウサ
セイチヨウサヨウ → チヨウセイサヨウ
セイチヨウソクド → ソクドチヨウセイ
セイテンハクジツ → ハクジツセイテン
セイナンシヨトウ → ナンセイシヨトウ
セイブツコウガク → ブツセイコウガク
センイシヨクブツ → ブンセツイシヨク
センシヨバンタン → センタンバンシヨ
センダンタイケイ → ダンタンケイセイ
ソウコウボウギヨ → ボウギヨソウコウ
ソウサマニユアル → マニユアルソウサ
ソウシンチヨウク → チヨウシンソウク
ソウチヨウカツジ → チジヨウカツソウ
ソクダンソツケツ → ソツケツソクダン
ゾウセツメモリー → メモリーゾウセツ
タイシンハタモト → ハタモトタイシン
タイジヤクジゼン → タイゼンジジヤク
タイメンコウツウ → タイメンツウコウ
タマノユオンセン → ユノマタオンセン
タンカクサイボウ → ボウカンタイサク
タンチモクヒヨウ → モクヒヨウタンチ
ダイシユウチヨウ → ダイチヨウシユウ
ダイジユウキヨウ → ダイジヨウキユウ
ダイヒヨウカンジ → ヒジヨウカイダン
ダンイホウシヨク → ホウシヨクダンイ
チジヨウカイセン → チジヨウカンセイ
チジヨウユウドウ → ドウチユウジヨウ
チホウカンチヨウ → チホウチヨウカン
チユウキヨウシン → チヨウシユウキン
チユウコウシヨク → チユウシヨウコク
チユウヨウトツキ → チヨウトツキユウ
チヨウカンキセイ → チヨウセイキカン
チヨウシユウジン → チヨウジユウシン
チヨウシユウハン → ハンシユウチヨウ
チンギンケイタイ → チンギンタイケイ
ツイカンエンバン → ツイカンバンエン
ツウガクデンシヤ → デンシヤツウガク
ツウキンデンシヤ → デンシヤツウキン
ツルノユオンセン → ユノツルオンセン
テイトウヘイシン → ヘイシンテイトウ
テツキシユウライ → テツキライシユウ
テンジヨウワラワ → ワラワテンジヨウ
テンネンシリヨウ → リンネテンシヨウ
デイスクブレーキ → ブレーキデイスク
デンゲンナイゾウ → ナイゾウデンゲン
デンシヨウブンカ → ブンカデンシヨウ
トウキマツシヨウ → マツシヨウトウキ
トウソウセイホン → トウホンセイソウ
トウヨウノマジヨ → ヨウトウノマジヨ
トクシユメンキヨ → メンキヨシユトク
トクベツオンシヤ → トクベツシヤオン
トシヨリアツカイ → トリアツカイシヨ
トモノユオンセン → ユノモトオンセン
ドウコウハンシヤ → ハンシヤコウドウ
ナカヤマオンセン → ヤマナカオンセン
ニユースバリユー → ニユスーバリユー
ニユウカイシカク → ニユウシカイカク
ニユウリヨクミス → ミスニユウリヨク
ニユウリヨクモジ → モジニユウリヨク
ハイビヘイリヨク → ヘイリヨクハイビ
ハツバイマドグチ → マドグチハツバイ
ハンスイハンセイ → ハンセイハンスイ
ハンバクタイセイ → バクハンタイセイ
ヒヨウメンカコウ → ヒヨウメンコウカ
ビフウリヨウゾク → リヨウフウビゾク
ビヨウガイチユウ → ビヨウチユウガイ
ピカクレスロマン → ピカレスクロマン
フアーストレデイ → レデイフアースト
フクゴウキギヨウ → フクゴウキヨウギ
プロトンザウルス → プロントザウルス
ヘイワキヨウテイ → ワヘイキヨウテイ
ヘイワジヨウヤク → ワヘイジヨウヤク
ヘンキヨウチタイ → ヘンタイチヨウキ
ヘンコウシユウキ → ヘンシユウコウキ
ボウガイコウサク → ボウサイコウガク
マシンカンキヨウ → マンキシヨウカン
マニピユレーター → マニユピレーター
ミサイルユウドウ → ユウドウミサイル
ミツユギヨウシヤ → ヤギユウミツヨシ
ミライイチヨソク → ミライヨソクイチ
ミンカンキギヨウ → ミンカンキヨウギ
メタモルフオーゼ → メモタルフオーゼ
ユウカイサツジン → ユウジンカイサツ
ライライラクラク → ラクラクライライ
リツケンセイタイ → リツケンタイセイ
リヨウカンキヨウ → リヨウヨウキカン
リヨウシユウシヨ → リヨウシユシヨウ
